P0KGK000
0B0K0S00
BTBBSWS0
0BBTBSK0
00SB0KGK
KSWSB0K0
GKSBTB00
K000B000