00K00000
0KGK0S00
00KBSWS0
00BTBSK0
00SB0KGK
KSWSB0K0
GKSBTB00
K000B00P